breast
159,194,165,185,175,175,177,167,182,159,192,147,195,153,195,166,190,163,188,160,185,160,185,167,187,171,201,178,210,181,211,188,210,193,202,205,196,214,195,211,175,201,172,199,165,199,161,198

face
56,161,61,167,66,169,71,177,75,182,80,185,80,188,87,197,88,204,84,201,85,205,91,207,98,204,103,199,103,196,109,194,115,191,124,186,133,178,133,167,133,158,129,155,127,154,123,157,118,154,116,156,114,153,112,154,108,154,106,151,105,148,102,147,98,148,95,153,90,154,86,158,82,158,79,158,76,157,72,158,67,158,58,160

hair
59,157,51,163,41,180,36,182,28,198,26,210,23,219,22,231,27,240,26,247,17,250,14,255,28,252,39,253,49,252,56,255,66,255,92,255,110,256,121,257,130,256,136,258,144,253,151,253,157,246,154,242,152,242,152,238,146,233,146,237,138,229,140,227,132,226,128,227,112,218,92,217,84,209,84,205,82,200,86,202,87,198,85,196,85,192,80,187,80,184,77,184,76,180,72,180,71,176,62,164,62,168,58,162,61,160

hands
211,137,200,145,198,150,193,149,195,159,195,166,191,165,189,162,186,161,185,162,185,169,193,173,200,176,209,180,211,195,202,205,196,216,192,210,176,203,167,196,154,197,145,207,141,215,143,224,158,245,180,250,212,254,224,254,230,249,237,237,240,220,239,204,234,179,232,168,234,161,231,151,227,143,219,136,214,137

legs
476,50,462,50,446,62,418,94,367,154,365,156,375,161,376,173,371,182,352,201,329,223,351,238,377,241,414,239,511,159,529,178,536,187,540,197,541,207,552,215,570,215,588,220,609,230,619,236,623,235,625,232,618,223,593,197,582,188,579,186,585,186,603,193,628,202,638,209,643,217,645,228,650,232,663,231,670,230,685,231,696,232,708,238,715,238,720,243,726,243,727,239,725,233,721,228,716,227,700,213,687,202,668,191,640,173,607,149,561,114,538,95,526,88,511,92,504,79,501,69,490,57

neck
134,178,126,187,109,196,105,197,99,205,93,209,96,215,107,215,118,219,131,229,137,227,145,230,145,224,142,217,146,206,153,199,158,196,163,186,150,189,145,189,138,184,135,183

torse
265,137,247,141,235,141,225,138,224,140,229,144,233,154,233,168,232,172,236,190,239,205,240,221,240,231,252,227,264,224,281,217,297,213,308,213,315,216,325,219,334,224,333,221,343,209,352,201,362,193,368,186,377,176,377,160,378,158,369,154,343,155,325,151,315,149,290,148,276,139